0000000000
0000000000
00######00
0##0000##0
##000000##
#00000000#
##000000##
0##0000##0
00######00
0000000000
0000000000