0000000000
0000000000
##########
#00000000#
#00000000#
#00000000#
#00000000#
#00000000#
##########
0000000000
0000000000